TILEMAP
32 28 							-- Size of tile map in tiles
32 64							-- Tile size & block size
images/tiles.png 	-- Tilesheet
8 8 								-- Number of tiles in tilesheet
00000000000000000000000000000000
00        0t                  00
00        00                  00
00s       s0         i    i i 00
000       00         j    j j 00
t0u       km        i0      i000
00        ln        j0      j000
0000i00s0000000s0000000t0000i000
0000j00000000000000000000000j000
00                            i0
00                            j0
00    i  i   i       qq     i 00
00           j       rr     j 00
00           i   i          i 00
00           j   j          j 00
00000000000000000000000000000000