TILEMAP
32 28 							-- Size of tile map in tiles
32 64							-- Tile size & block size
images/tiles2.png 	-- Tilesheet
8 8 								-- Number of tiles in tilesheet
00000000000000000000000000000000
00         t                  00
00                            00
00s       s        ii     i i 00
000                jj     j j 00
t00               iii       i000
00                jjj       j000
0000i00s0000000s0000000t0000i000
0000j00000000000000000000000j000
00                            i0
00                            j0
00                          ii00
00                          jj00
00             i         iiiii00
00             j         jjjjj00
00000000000000000000000000000000