TILEMAP
36 28 							-- Size of tile map in tiles
32 64							-- Tile size & block size
images/tiles.png 	-- Tilesheet
4 4 								-- Number of tiles in tilesheet
111111111111111111111111111111111111
11                                11
11                                11
1111                              11
1122            111111    1111  1111
11        11        22     22     11
11        22        22     22     11
11  11111111111111111111111122111111
11  11111111111111111111111111111111
11                                11
11                                11
1111111  11111              11    11
1122         2              22    11
1122         21  1   11     221  111
1122         22  2   22     222  211
111111111111111121111111111122111111


